3 2 411 1809 
2 7 2672 2140 4841 1314 4744 650 14 
2 9 2919 5206 5137 1346 5136 2495 27 5032 345 
1 8 14 4623 2873 2967 4753 1634 4794 4816 
1 9 14 4631 193 4576 4577 4555 4583 1145 4624 
3 9 3196 765 2612 299 3461 1882 3499 3522 3534 
1 4 4704 2073 4632 4589 
1 9 4704 781 4614 4579 4520 279 4427 2115 222 
1 6 1043 3942 3918 2338 3924 1536 
1 10 14 1482 3070 4554 4515 4473 1302 4518 4492 4453 
1 6 4493 241 4384 682 4278 1800 
1 4 4577 4516 366 4435 
1 6 4753 98 2930 2834 4715 2748 
1 11 4841 1485 1413 2699 4895 4922 4948 129 4928 512 1329 
1 6 4631 4668 4672 358 4766 4754 
1 6 4493 4454 2800 2685 4358 625 
1 6 3803 2566 2795 3888 3923 1691 
1 4 4579 2365 3313 2230 
1 4 4427 4388 4387 3262 
1 4 1043 4010 3229 4112 
2 6 2280 859 3507 1116 367 12 
2 11 3196 1064 3376 1955 895 2437 3362 191 1033 3400 522 
1 4 3376 291 1331 3356 
2 14 128 227 1060 1024 412 738 3374 640 2540 1899 621 3414 526 3437 
1 6 1691 3985 4014 2043 365 3237 
1 5 1691 4002 89 2443 4099 
1 7 4136 4161 2118 4251 1774 4320 2910 
1 5 276 4415 2837 2870 1377 
1 3 4321 2309 4441 
1 4 4441 1546 2754 4510 
1 4 2746 4535 2920 411 
1 6 345 2530 324 4837 627 808 
1 7 4510 2151 4612 2234 4728 3144 273 
1 8 501 3510 208 2020 3491 685 3459 392 
1 6 95 3562 1448 1074 1274 3491 
1 6 95 3607 3245 1450 1013 3662 
1 3 95 2244 3629 
1 3 3607 1703 1819 
1 6 2020 1771 3445 1394 1514 3391 
1 3 2930 1501 4554 
1 3 2967 2573 4744 
1 2 1485 4766 
1 31 538 2785 2170 2344 1148 3846 729 269 1737 1744 421 2686 148 3786 3813 3828 1048 3811 3179 3875 3862 1999 3911 3906 3885 3861 1995 3904 3860 3857 3833 
1 14 3833 3817 2945 3777 1491 3727 3745 546 3712 3696 672 3669 1962 173 
1 2 3860 3900 
1 20 3833 3804 3790 1169 3795 2007 3785 993 3124 3788 3792 3797 525 3789 926 3791 1865 1350 3768 2364 
1 5 3929 2306 1090 2032 3797 
1 6 2007 2803 1058 820 1203 484 
1 4 3795 1254 47 3900 
1 6 1877 1286 1607 2270 636 3900 
1 3 14 4545 4493 
1 10 1536 3943 3979 1215 4069 905 1081 4225 410 4310 
1 6 4310 4276 1790 4325 4428 3031 
1 4 3031 4487 4538 4589 
1 4 1536 2499 3847 684 
1 8 684 2926 3793 3764 3735 3719 2167 697 
1 6 697 49 3678 3212 619 3693 
1 9 3212 3708 3722 3751 3784 444 1050 2895 3942 
1 3 1050 3201 718 
1 4 3124 3744 890 3702 
1 5 1865 3859 36 3910 1661 
1 3 1060 793 3356 
1 4 1610 65 1871 2666 
1 9 2280 3468 1457 3465 3155 3496 931 3527 2030 
1 3 227 2145 556 
1 3 3429 692 556 
1 3 2666 601 1882 
1 2 3499 2454 
1 6 3300 3685 1056 3090 3743 3789 
1 8 1056 1428 3303 545 3701 3702 614 820 
1 6 820 789 3679 3687 3680 1962 
1 4 3562 3565 1009 3576 
1 4 1853 306 23 3371 
1 3 306 3351 1799 
1 2 23 1799 
1 2 4441 2746 
1 5 2746 4569 688 492 808 
1 5 808 4727 2079 2449 4612 
1 2 4510 4415 
1 4 1691 4020 2436 4136 
1 5 4136 2741 4219 2174 1377 
1 3 3888 1768 1688 
1 4 2795 428 3883 3864 
3 7 1631 1360 948 2927 4130 3087 1022 
1 3 2280 1466 3429 
1 2 3429 1610 
1 2 1610 128 
3 3 3196 1229 128 
1 4 2437 3354 888 1726 
1 3 3356 453 3342 
1 4 3356 2180 28 1643 
1 3 412 1721 1643 
1 4 640 1297 583 2747 
1 5 738 1648 3352 258 495 
1 5 931 590 662 3525 367 
1 3 1257 351 427 
